ATTATACAGCTTATCTAATA -> TTATACAGCTTATCTAATAG
TCCGTGACAATATGAGCAAT -> CCGTGACAATATGAGCAATT
ACATGCTAATTAAGGTTTTA -> CATGCTAATTAAGGTTTTAC
CGATATATACCGTTGTTGAA -> GATATATACCGTTGTTGAAG
CTTAACTAAATTTCGTCAGT -> TTAACTAAATTTCGTCAGTC
GACGTTTCTCCCTTTGGTCG -> ACGTTTCTCCCTTTGGTCGT
GCCAAAGGAGCGGACATGCT -> CCAAAGGAGCGGACATGCTA
TGTCGGTAACTATATGCTAA -> GTCGGTAACTATATGCTAAC
GTATCGGTAGACGAATGTCC -> TATCGGTAGACGAATGTCCA
TTACGACACGCTTGGGATTA -> TACGACACGCTTGGGATTAC
CGTAGCCCTCAATACCGTGG -> GTAGCCCTCAATACCGTGGT
CTTTGAGACATGATTGAGCC -> TTTGAGACATGATTGAGCCA
TGAGTAATCTAAGAATAACT -> GAGTAATCTAAGAATAACTG
CTCTGGGGAGATAGAAGGAT -> TCTGGGGAGATAGAAGGATT
ATATACCGTTGTTGAAGTAT -> TATACCGTTGTTGAAGTATA
ATCTAATAGGTGATAGAAAT -> TCTAATAGGTGATAGAAATC
CCGTGACAATATGAGCAATT -> CGTGACAATATGAGCAATTC
ACTGGCCGGAAATCACCCCC -> CTGGCCGGAAATCACCCCCC
TGTGAAAAGTTGACCCCACC -> GTGAAAAGTTGACCCCACCA
AGGCTTAACTAAATTTCGTC -> GGCTTAACTAAATTTCGTCA
TACCTTATCGCGTTACCGTC -> ACCTTATCGCGTTACCGTCT
AACCAATTACTCTGGCCCGC -> ACCAATTACTCTGGCCCGCG
ATATGCTAACGCTGGTATCC -> TATGCTAACGCTGGTATCCG
TGTGTGATAGCGGGAGTACC -> GTGTGATAGCGGGAGTACCC
CCCTCAATACCGTGGTCCAT -> CCTCAATACCGTGGTCCATA
GGACATAATAGTAGGGGCGA -> GACATAATAGTAGGGGCGAG
CCATACGACCGCCTGCGATA -> CATACGACCGCCTGCGATAC
CAATTACTCTGGCCCGCGGC -> AATTACTCTGGCCCGCGGCC
TCGGTAACTATATGCTAACG -> CGGTAACTATATGCTAACGC
GTTACCGTCTTAGTCGTGTC -> TTACCGTCTTAGTCGTGTCC
CATTATACAGCTTATCTAAT -> ATTATACAGCTTATCTAATA
CATGAGCGGGTTGGACATAA -> ATGAGCGGGTTGGACATAAT
ACTTCCGTCACTCGGGTTTT -> CTTCCGTCACTCGGGTTTTC
TTCATGCAAGGGAATCTAGG -> TCATGCAAGGGAATCTAGGA
ATAGAAGGATTCTCCTCGAT -> TAGAAGGATTCTCCTCGATA
GACACGCTTGGGATTACATT -> ACACGCTTGGGATTACATTA
CCGTTATTTAAACTTCCGTC -> CGTTATTTAAACTTCCGTCA
GACCTAGTGACACCAAGGTA -> ACCTAGTGACACCAAGGTAG
CTGTAGGTCCCAAGCCTCTG -> TGTAGGTCCCAAGCCTCTGG
AGACGAATGTCCACATACGT -> GACGAATGTCCACATACGTA
TACAGCTTATCTAATAGGTG -> ACAGCTTATCTAATAGGTGA
CAAGGCGCCTCACGTGTCAC -> AAGGCGCCTCACGTGTCACC
TCGAGCGGCATACAAGCAGC -> CGAGCGGCATACAAGCAGCC
CTTCCGTCACTCGGGTTTTC -> TTCCGTCACTCGGGTTTTCG
ACTATATGCTAACGCTGGTA -> CTATATGCTAACGCTGGTAT
GCTACTAGATATCGAGCGGC -> CTACTAGATATCGAGCGGCA
AGAAGGATTCTCCTCGATAT -> GAAGGATTCTCCTCGATATA
TTCGAGCTGTAGGTCCCAAG -> TCGAGCTGTAGGTCCCAAGC
ATTGTGAAAAGTTGACCCCA -> TTGTGAAAAGTTGACCCCAC
GGTTAAAGCGCCCCATTGTG -> GTTAAAGCGCCCCATTGTGA
GTTGAAACTTCTAATTGACT -> TTGAAACTTCTAATTGACTA
TAATAGTAGGGGCGAGCCTT -> AATAGTAGGGGCGAGCCTTG
AGATATCGAGCGGCATACAA -> GATATCGAGCGGCATACAAG
TAGCGGGAGTACCCTTCGGT -> AGCGGGAGTACCCTTCGGTG
GAACCTTTATTCATGCAAGG -> AACCTTTATTCATGCAAGGG
GCTAACGCTGGTATCCGTGA -> CTAACGCTGGTATCCGTGAC
TTCTCCCTTTGGTCGTCATG -> TCTCCCTTTGGTCGTCATGA
CAAAGGAGCGGACATGCTAA -> AAAGGAGCGGACATGCTAAT
GAGACATGATTGAGCCAAAG -> AGACATGATTGAGCCAAAGG
CGTGACAATATGAGCAATTC -> GTGACAATATGAGCAATTCC
GCGAGCCTTGAAGAAGTTAC -> CGAGCCTTGAAGAAGTTACT
ACGCTGGTATCCGTGACAAT -> CGCTGGTATCCGTGACAATA
CCAATTACTCTGGCCCGCGG -> CAATTACTCTGGCCCGCGGC
TAGCCCTCAATACCGTGGTC -> AGCCCTCAATACCGTGGTCC
CATACAAGCAGCCCTCCTGT -> ATACAAGCAGCCCTCCTGTA
AGGGAATCTAGGACGTTACG -> GGGAATCTAGGACGTTACGA
CCGCGGCCGTGCCTTTGAGA -> CGCGGCCGTGCCTTTGAGAC
CTAAATTTCGTCAGTCCGTT -> TAAATTTCGTCAGTCCGTTA
TATACTATGTGGACAACTCA -> ATACTATGTGGACAACTCAA
GATTACATTAATTGCGCGAC -> ATTACATTAATTGCGCGACA
GTATATCCGCCCGCAAGCTA -> TATATCCGCCCGCAAGCTAA
AATCACCCCCCTGTTTGATT -> ATCACCCCCCTGTTTGATTC
TTGTTGAAGTATAGTAGGCC -> TGTTGAAGTATAGTAGGCCG
CCGGATAAACCAATTACTCT -> CGGATAAACCAATTACTCTG
ATATATACCGTTGTTGAAGT -> TATATACCGTTGTTGAAGTA
GTTACGACACGCTTGGGATT -> TTACGACACGCTTGGGATTA
GTAATCTAAGAATAACTGGC -> TAATCTAAGAATAACTGGCC
CGAGCCTTGAAGAAGTTACT -> GAGCCTTGAAGAAGTTACTT
TTTACGTAATCTTGTGTGTG -> TTACGTAATCTTGTGTGTGA
ATTGACTACAGATGACTGAC -> TTGACTACAGATGACTGACC
CGAATGTCCACATACGTAGA -> GAATGTCCACATACGTAGAC
AACTGGCCGGAAATCACCCC -> ACTGGCCGGAAATCACCCCC
ATAGTAGGGGCGAGCCTTGA -> TAGTAGGGGCGAGCCTTGAA
GCGCCCCATTGTGAAAAGTT -> CGCCCCATTGTGAAAAGTTG
TTATTCATGCAAGGGAATCT -> TATTCATGCAAGGGAATCTA
GTGATAGCGGGAGTACCCTT -> TGATAGCGGGAGTACCCTTC
TCCTCGATATATACCGTTGT -> CCTCGATATATACCGTTGTT
ACAGCTTATCTAATAGGTGA -> CAGCTTATCTAATAGGTGAT
AACTAAATTTCGTCAGTCCG -> ACTAAATTTCGTCAGTCCGT
TCCGGTAGGGGACCGTGGCT -> CCGGTAGGGGACCGTGGCTA
TAGGGGACCGTGGCTATCCA -> AGGGGACCGTGGCTATCCAT
TCCCAAGCCTCTGGGGAGAT -> CCCAAGCCTCTGGGGAGATA
GTGCTAGCTGACAATCGTAG -> TGCTAGCTGACAATCGTAGC
AATTAAGGTTTTACGTAATC -> ATTAAGGTTTTACGTAATCT
CAATTCCACGGGATTGATAT -> AATTCCACGGGATTGATATC
GTTCGAGCTGTAGGTCCCAA -> TTCGAGCTGTAGGTCCCAAG
GATTCTCCTCGATATATACC -> ATTCTCCTCGATATATACCG
TATTCATGCAAGGGAATCTA -> ATTCATGCAAGGGAATCTAG
GAAGGATTCTCCTCGATATA -> AAGGATTCTCCTCGATATAT
AGCGCCCCATTGTGAAAAGT -> GCGCCCCATTGTGAAAAGTT
CCTTTATTCATGCAAGGGAA -> CTTTATTCATGCAAGGGAAT
TTGCGCGACAGGGTTAAAGC -> TGCGCGACAGGGTTAAAGCG
TCAAATGTGTGCACGGGTCG -> CAAATGTGTGCACGGGTCGG
TGAAGAAGTTACTTTGCGTG -> GAAGAAGTTACTTTGCGTGT
GTGGACAACTCAAATGTGTG -> TGGACAACTCAAATGTGTGC
CCAAGGTAGCTACTAGATAT -> CAAGGTAGCTACTAGATATC
CACGGGATTGATATCGGCAT -> ACGGGATTGATATCGGCATC
TAGAACCTTTATTCATGCAA -> AGAACCTTTATTCATGCAAG
CGGCATACAAGCAGCCCTCC -> GGCATACAAGCAGCCCTCCT
GGGTTAAAGCGCCCCATTGT -> GGTTAAAGCGCCCCATTGTG
GAAGTTACTTTGCGTGTTCA -> AAGTTACTTTGCGTGTTCAG
ACTACTTTTTGAGTAATCTA -> CTACTTTTTGAGTAATCTAA
GTGTGCACGGGTCGGGTGTA -> TGTGCACGGGTCGGGTGTAC
GACTGACCTAGTGACACCAA -> ACTGACCTAGTGACACCAAG
GACCCCACCAATTAGTACCT -> ACCCCACCAATTAGTACCTT
AGGATTCTCCTCGATATATA -> GGATTCTCCTCGATATATAC
GCACGGGTCGGGTGTACCGT -> CACGGGTCGGGTGTACCGTG
TAACTAAATTTCGTCAGTCC -> AACTAAATTTCGTCAGTCCG
CCACATACGTAGACACTACT -> CACATACGTAGACACTACTT
TTGAGTAATCTAAGAATAAC -> TGAGTAATCTAAGAATAACT
TTTGAGACATGATTGAGCCA -> TTGAGACATGATTGAGCCAA
ACTGTGGAGGCTTAACTAAA -> CTGTGGAGGCTTAACTAAAT
AAGGATTCTCCTCGATATAT -> AGGATTCTCCTCGATATATA
CGACACGCTTGGGATTACAT -> GACACGCTTGGGATTACATT
TAAACTTCCGTCACTCGGGT -> AAACTTCCGTCACTCGGGTT
TAACGCTGGTATCCGTGACA -> AACGCTGGTATCCGTGACAA
CGTCACTCGGGTTTTCGTAG -> GTCACTCGGGTTTTCGTAGA
CGACAGGGTTAAAGCGCCCC -> GACAGGGTTAAAGCGCCCCA
CTTGTGTGTGATAGCGGGAG -> TTGTGTGTGATAGCGGGAGT
TGGCCCGCGGCCGTGCCTTT -> GGCCCGCGGCCGTGCCTTTG
GGTAGCTACTAGATATCGAG -> GTAGCTACTAGATATCGAGC
TTGCGTGTTCAGGGATTGAG -> TGCGTGTTCAGGGATTGAGT
CGTGTCACCATGGCGTTTCT -> GTGTCACCATGGCGTTTCTC
TAAGAATAACTGGCCGGAAA -> AAGAATAACTGGCCGGAAAT
CAAGCCTCTGGGGAGATAGA -> AAGCCTCTGGGGAGATAGAA
ACGGGTCGGGTGTACCGTGT -> CGGGTCGGGTGTACCGTGTC
ATTACTCTGGCCCGCGGCCG -> TTACTCTGGCCCGCGGCCGT
GGCATACAAGCAGCCCTCCT -> GCATACAAGCAGCCCTCCTG
CGGGAGTACCCTTCGGTGCT -> GGGAGTACCCTTCGGTGCTC
CATAATAGTAGGGGCGAGCC -> ATAATAGTAGGGGCGAGCCT
GATTGAGCCAAAGGAGCGGA -> ATTGAGCCAAAGGAGCGGAC
TTAAACTTCCGTCACTCGGG -> TAAACTTCCGTCACTCGGGT
GTGTCACCATGGCGTTTCTC -> TGTCACCATGGCGTTTCTCG
TGTTGAAGTATAGTAGGCCG -> GTTGAAGTATAGTAGGCCGT
CTCCCTTTGGTCGTCATGAG -> TCCCTTTGGTCGTCATGAGC
CCTCACGTGTCACCATGGCG -> CTCACGTGTCACCATGGCGT
TGTTTGATTCCTAAATCCGT -> GTTTGATTCCTAAATCCGTA
CTACAGATGACTGACCTAGT -> TACAGATGACTGACCTAGTG
TTTGAGTAATCTAAGAATAA -> TTGAGTAATCTAAGAATAAC
ACCATGGCGTTTCTCGTTAT -> CCATGGCGTTTCTCGTTATA
GTGCACGGGTCGGGTGTACC -> TGCACGGGTCGGGTGTACCG
GCCGTGCCTTTGAGACATGA -> CCGTGCCTTTGAGACATGAT
CCGTGCCTTTGAGACATGAT -> CGTGCCTTTGAGACATGATT
TATCGCGTTACCGTCTTAGT -> ATCGCGTTACCGTCTTAGTC
ACGTAGACACTACTTTTTGA -> CGTAGACACTACTTTTTGAG
CTAACGCTGGTATCCGTGAC -> TAACGCTGGTATCCGTGACA
TCCGTTATTTAAACTTCCGT -> CCGTTATTTAAACTTCCGTC
CGTAGAACCTTTATTCATGC -> GTAGAACCTTTATTCATGCA
CTAATAGGTGATAGAAATCT -> TAATAGGTGATAGAAATCTG
AGCCAAAGGAGCGGACATGC -> GCCAAAGGAGCGGACATGCT
CCGTGCTAGCTGACAATCGT -> CGTGCTAGCTGACAATCGTA
GTCGTCATGAGCGGGTTGGA -> TCGTCATGAGCGGGTTGGAC
CAATATGAGCAATTCCACGG -> AATATGAGCAATTCCACGGG
TAACTATATGCTAACGCTGG -> AACTATATGCTAACGCTGGT
GGGTGTACCGTGTCGGTAAC -> GGTGTACCGTGTCGGTAACT
CGTAGTTCGAGCTGTAGGTC -> GTAGTTCGAGCTGTAGGTCC
TCACCATGGCGTTTCTCGTT -> CACCATGGCGTTTCTCGTTA
GAGTACCCTTCGGTGCTCCA -> AGTACCCTTCGGTGCTCCAT
CCCTGTTTGATTCCTAAATC -> CCTGTTTGATTCCTAAATCC
ATGACTGACCTAGTGACACC -> TGACTGACCTAGTGACACCA
ATACGTAGACACTACTTTTT -> TACGTAGACACTACTTTTTG
AATTGCGCGACAGGGTTAAA -> ATTGCGCGACAGGGTTAAAG
TGAGCCAAAGGAGCGGACAT -> GAGCCAAAGGAGCGGACATG
ACGAATGTCCACATACGTAG -> CGAATGTCCACATACGTAGA
AACTCAAATGTGTGCACGGG -> ACTCAAATGTGTGCACGGGT
ATGCAAGGGAATCTAGGACG -> TGCAAGGGAATCTAGGACGT
GCGCGACAGGGTTAAAGCGC -> CGCGACAGGGTTAAAGCGCC
TACTCTGGCCCGCGGCCGTG -> ACTCTGGCCCGCGGCCGTGC
GTCCGACGTTTCTCCCTTTG -> TCCGACGTTTCTCCCTTTGG
TCTAATAGGTGATAGAAATC -> CTAATAGGTGATAGAAATCT
CAAGCAGCCCTCCTGTATCG -> AAGCAGCCCTCCTGTATCGG
CAAATGTGTGCACGGGTCGG -> AAATGTGTGCACGGGTCGGG
CCGTGTCGGTAACTATATGC -> CGTGTCGGTAACTATATGCT
CGTTTCTCGTTATACTATGT -> GTTTCTCGTTATACTATGTG
ATTAAGGTTTTACGTAATCT -> TTAAGGTTTTACGTAATCTT
AATGTCCACATACGTAGACA -> ATGTCCACATACGTAGACAC
CTGGGGAGATAGAAGGATTC -> TGGGGAGATAGAAGGATTCT
AATCTAGGACGTTACGACAC -> ATCTAGGACGTTACGACACG
ACGACCGCCTGCGATACTGT -> CGACCGCCTGCGATACTGTG
GAAATCACCCCCCTGTTTGA -> AAATCACCCCCCTGTTTGAT
TTGACCCCACCAATTAGTAC -> TGACCCCACCAATTAGTACC
CAGCTTATCTAATAGGTGAT -> AGCTTATCTAATAGGTGATA
TGGAGGCTTAACTAAATTTC -> GGAGGCTTAACTAAATTTCG
TTCAGGGATTGAGTATATCC -> TCAGGGATTGAGTATATCCG
CTGACCTAGTGACACCAAGG -> TGACCTAGTGACACCAAGGT
TTGTGAAAAGTTGACCCCAC -> TGTGAAAAGTTGACCCCACC
TTTGGTCGTCATGAGCGGGT -> TTGGTCGTCATGAGCGGGTT
CAGTCCGTTATTTAAACTTC -> AGTCCGTTATTTAAACTTCC
GAGCGGGTTGGACATAATAG -> AGCGGGTTGGACATAATAGT
CGTGTTCAGGGATTGAGTAT -> GTGTTCAGGGATTGAGTATA
CGGGATTGATATCGGCATCC -> GGGATTGATATCGGCATCCG
GCGTTTCTCGTTATACTATG -> CGTTTCTCGTTATACTATGT
GCCGGAAATCACCCCCCTGT -> CCGGAAATCACCCCCCTGTT
CCTCTGGGGAGATAGAAGGA -> CTCTGGGGAGATAGAAGGAT
AAGCGCCCCATTGTGAAAAG -> AGCGCCCCATTGTGAAAAGT
GATATATACCGTTGTTGAAG -> ATATATACCGTTGTTGAAGT
TTGATATCGGCATCCGGTAG -> TGATATCGGCATCCGGTAGG
GGAGCGGACATGCTAATTAA -> GAGCGGACATGCTAATTAAG
ACAGGGTTAAAGCGCCCCAT -> CAGGGTTAAAGCGCCCCATT
CTAGATATCGAGCGGCATAC -> TAGATATCGAGCGGCATACA
ACCCCACCAATTAGTACCTT -> CCCCACCAATTAGTACCTTA
TCGGTGCTCCATCCAGGCAG -> CGGTGCTCCATCCAGGCAGT
TATATCCGCCCGCAAGCTAA -> ATATCCGCCCGCAAGCTAAC
TTGGTCGTCATGAGCGGGTT -> TGGTCGTCATGAGCGGGTTG
GTACCTTATCGCGTTACCGT -> TACCTTATCGCGTTACCGTC
TATACCGTTGTTGAAGTATA -> ATACCGTTGTTGAAGTATAG
CTTATCTAATAGGTGATAGA -> TTATCTAATAGGTGATAGAA
TTTTCGTAGAACCTTTATTC -> TTTCGTAGAACCTTTATTCA
AATATGAGCAATTCCACGGG -> ATATGAGCAATTCCACGGGA
TAGCTGACAATCGTAGCCCT -> AGCTGACAATCGTAGCCCTC
GGTTTTACGTAATCTTGTGT -> GTTTTACGTAATCTTGTGTG
TAGTTCGAGCTGTAGGTCCC -> AGTTCGAGCTGTAGGTCCCA
AGTACCCTTCGGTGCTCCAT -> GTACCCTTCGGTGCTCCATC
AAACTTCCGTCACTCGGGTT -> AACTTCCGTCACTCGGGTTT
CTGGTATCCGTGACAATATG -> TGGTATCCGTGACAATATGA
CCCGCGGCCGTGCCTTTGAG -> CCGCGGCCGTGCCTTTGAGA
CTAACTCAAGGCGCCTCACG -> TAACTCAAGGCGCCTCACGT
CTGTTTGATTCCTAAATCCG -> TGTTTGATTCCTAAATCCGT
AGGCGCCTCACGTGTCACCA -> GGCGCCTCACGTGTCACCAT
CGCGTTACCGTCTTAGTCGT -> GCGTTACCGTCTTAGTCGTG
AGAACCTTTATTCATGCAAG -> GAACCTTTATTCATGCAAGG
GTTAAAGCGCCCCATTGTGA -> TTAAAGCGCCCCATTGTGAA
CCACCAATTAGTACCTTATC -> CACCAATTAGTACCTTATCG
AGGGATTGAGTATATCCGCC -> GGGATTGAGTATATCCGCCC
TACATTAATTGCGCGACAGG -> ACATTAATTGCGCGACAGGG
CCCTTCGGTGCTCCATCCAG -> CCTTCGGTGCTCCATCCAGG
ACGGGATTGATATCGGCATC -> CGGGATTGATATCGGCATCC
GGACGTTACGACACGCTTGG -> GACGTTACGACACGCTTGGG
TCTCCTCGATATATACCGTT -> CTCCTCGATATATACCGTTG
TCGTGTCCGACGTTTCTCCC -> CGTGTCCGACGTTTCTCCCT
GCCCTCCTGTATCGGTAGAC -> CCCTCCTGTATCGGTAGACG
AGTCGTGTCCGACGTTTCTC -> GTCGTGTCCGACGTTTCTCC
GATACTGTGGAGGCTTAACT -> ATACTGTGGAGGCTTAACTA
AGTTCGAGCTGTAGGTCCCA -> GTTCGAGCTGTAGGTCCCAA
GTCTTAGTCGTGTCCGACGT -> TCTTAGTCGTGTCCGACGTT
CAGCCCTCCTGTATCGGTAG -> AGCCCTCCTGTATCGGTAGA
GGAGGCTTAACTAAATTTCG -> GAGGCTTAACTAAATTTCGT
TTTCGTCAGTCCGTTATTTA -> TTCGTCAGTCCGTTATTTAA
ATTCCACGGGATTGATATCG -> TTCCACGGGATTGATATCGG
AGCCCTCAATACCGTGGTCC -> GCCCTCAATACCGTGGTCCA
GCGGGAGTACCCTTCGGTGC -> CGGGAGTACCCTTCGGTGCT
TCACCCCCCTGTTTGATTCC -> CACCCCCCTGTTTGATTCCT
CGGATAAACCAATTACTCTG -> GGATAAACCAATTACTCTGG
TGGTCGTCATGAGCGGGTTG -> GGTCGTCATGAGCGGGTTGG
TGCTAGAACCCGGATAAACC -> GCTAGAACCCGGATAAACCA
TGTGTGTGATAGCGGGAGTA -> GTGTGTGATAGCGGGAGTAC
ACCGCCTGCGATACTGTGGA -> CCGCCTGCGATACTGTGGAG
AACTTCCGTCACTCGGGTTT -> ACTTCCGTCACTCGGGTTTT
CTAGTGACACCAAGGTAGCT -> TAGTGACACCAAGGTAGCTA
CCCCCTGTTTGATTCCTAAA -> CCCCTGTTTGATTCCTAAAT
AGTGACACCAAGGTAGCTAC -> GTGACACCAAGGTAGCTACT
GGCCGGAAATCACCCCCCTG -> GCCGGAAATCACCCCCCTGT
CCTGTATCGGTAGACGAATG -> CTGTATCGGTAGACGAATGT
AGTTACTTTGCGTGTTCAGG -> GTTACTTTGCGTGTTCAGGG
GAATGTCCACATACGTAGAC -> AATGTCCACATACGTAGACA
CCAAAGGAGCGGACATGCTA -> CAAAGGAGCGGACATGCTAA
GCCTTTGAGACATGATTGAG -> CCTTTGAGACATGATTGAGC
CGCCCCATTGTGAAAAGTTG -> GCCCCATTGTGAAAAGTTGA
AAAAGTTGACCCCACCAATT -> AAAGTTGACCCCACCAATTA
GTGTGTGATAGCGGGAGTAC -> TGTGTGATAGCGGGAGTACC
AGCGGACATGCTAATTAAGG -> GCGGACATGCTAATTAAGGT
GACTACAGATGACTGACCTA -> ACTACAGATGACTGACCTAG
TTATTTAAACTTCCGTCACT -> TATTTAAACTTCCGTCACTC
GCTATCCATTATACAGCTTA -> CTATCCATTATACAGCTTAT
ACACGCTTGGGATTACATTA -> CACGCTTGGGATTACATTAA
GTCCCAAGCCTCTGGGGAGA -> TCCCAAGCCTCTGGGGAGAT
AGACACTACTTTTTGAGTAA -> GACACTACTTTTTGAGTAAT
TTGAAGTATAGTAGGCCGTG -> TGAAGTATAGTAGGCCGTGC
ATCCGTAGTTCGAGCTGTAG -> TCCGTAGTTCGAGCTGTAGG
AGTAGGCCGTGCTAGCTGAC -> GTAGGCCGTGCTAGCTGACA
ATGTCCACATACGTAGACAC -> TGTCCACATACGTAGACACT
CCCGCAAGCTAACTCAAGGC -> CCGCAAGCTAACTCAAGGCG
TCGTAGCCCTCAATACCGTG -> CGTAGCCCTCAATACCGTGG
AAGGCGCCTCACGTGTCACC -> AGGCGCCTCACGTGTCACCA
TGATATCGGCATCCGGTAGG -> GATATCGGCATCCGGTAGGG
GGGATTACATTAATTGCGCG -> GGATTACATTAATTGCGCGA
TCAGGGATTGAGTATATCCG -> CAGGGATTGAGTATATCCGC
TTATACTATGTGGACAACTC -> TATACTATGTGGACAACTCA
TCCGTAGTTCGAGCTGTAGG -> CCGTAGTTCGAGCTGTAGGT
TGCGTGTTCAGGGATTGAGT -> GCGTGTTCAGGGATTGAGTA
GTGTCCGACGTTTCTCCCTT -> TGTCCGACGTTTCTCCCTTT
GTCGGTAACTATATGCTAAC -> TCGGTAACTATATGCTAACG
GTGTGATAGCGGGAGTACCC -> TGTGATAGCGGGAGTACCCT
GGTTTTCGTAGAACCTTTAT -> GTTTTCGTAGAACCTTTATT
CGTTGTTGAAGTATAGTAGG -> GTTGTTGAAGTATAGTAGGC
AATACCGTGGTCCATACGAC -> ATACCGTGGTCCATACGACC
CGGGTTGGACATAATAGTAG -> GGGTTGGACATAATAGTAGG
AGAAATCTGCTAGAACCCGG -> GAAATCTGCTAGAACCCGGA
CCCACCAATTAGTACCTTAT -> CCACCAATTAGTACCTTATC
ATGCTAATTAAGGTTTTACG -> TGCTAATTAAGGTTTTACGT
ACTAGATATCGAGCGGCATA -> CTAGATATCGAGCGGCATAC
GACGAATGTCCACATACGTA -> ACGAATGTCCACATACGTAG
GCATACAAGCAGCCCTCCTG -> CATACAAGCAGCCCTCCTGT
AGTCCGTTATTTAAACTTCC -> GTCCGTTATTTAAACTTCCG
TGTGTGCACGGGTCGGGTGT -> GTGTGCACGGGTCGGGTGTA
GCTTATCTAATAGGTGATAG -> CTTATCTAATAGGTGATAGA
GACACCAAGGTAGCTACTAG -> ACACCAAGGTAGCTACTAGA
CTGACAATCGTAGCCCTCAA -> TGACAATCGTAGCCCTCAAT
AGCTTATCTAATAGGTGATA -> GCTTATCTAATAGGTGATAG
TAAATCCGTAGTTCGAGCTG -> AAATCCGTAGTTCGAGCTGT
TCGTAGAACCTTTATTCATG -> CGTAGAACCTTTATTCATGC
TACGTAATCTTGTGTGTGAT -> ACGTAATCTTGTGTGTGATA
GCAAGGGAATCTAGGACGTT -> CAAGGGAATCTAGGACGTTA
GAATCTAGGACGTTACGACA -> AATCTAGGACGTTACGACAC
CCTTCGGTGCTCCATCCAGG -> CTTCGGTGCTCCATCCAGGC
CCTTTGAGACATGATTGAGC -> CTTTGAGACATGATTGAGCC
ATTGATATCGGCATCCGGTA -> TTGATATCGGCATCCGGTAG
TATCGAGCGGCATACAAGCA -> ATCGAGCGGCATACAAGCAG
TGCTAACGCTGGTATCCGTG -> GCTAACGCTGGTATCCGTGA
GATTGATATCGGCATCCGGT -> ATTGATATCGGCATCCGGTA
TGAGTATATCCGCCCGCAAG -> GAGTATATCCGCCCGCAAGC
CTTATCGCGTTACCGTCTTA -> TTATCGCGTTACCGTCTTAG
CCTAGTGACACCAAGGTAGC -> CTAGTGACACCAAGGTAGCT
TATGAGCAATTCCACGGGAT -> ATGAGCAATTCCACGGGATT
TACTTTGCGTGTTCAGGGAT -> ACTTTGCGTGTTCAGGGATT
GTTCAGGGATTGAGTATATC -> TTCAGGGATTGAGTATATCC
TACCGTGGTCCATACGACCG -> ACCGTGGTCCATACGACCGC
ATCCGTGACAATATGAGCAA -> TCCGTGACAATATGAGCAAT
GTCGGGTGTACCGTGTCGGT -> TCGGGTGTACCGTGTCGGTA
AGCTGACAATCGTAGCCCTC -> GCTGACAATCGTAGCCCTCA
GTTGACCCCACCAATTAGTA -> TTGACCCCACCAATTAGTAC
CATGCTAATTAAGGTTTTAC -> ATGCTAATTAAGGTTTTACG
CATACGACCGCCTGCGATAC -> ATACGACCGCCTGCGATACT
TAAAGCGCCCCATTGTGAAA -> AAAGCGCCCCATTGTGAAAA
GACATGCTAATTAAGGTTTT -> ACATGCTAATTAAGGTTTTA
AAAGCGCCCCATTGTGAAAA -> AAGCGCCCCATTGTGAAAAG
TCCACATACGTAGACACTAC -> CCACATACGTAGACACTACT
CTAAATCCGTAGTTCGAGCT -> TAAATCCGTAGTTCGAGCTG
ATATCGAGCGGCATACAAGC -> TATCGAGCGGCATACAAGCA
CACCAATTAGTACCTTATCG -> ACCAATTAGTACCTTATCGC
CCGTCACTCGGGTTTTCGTA -> CGTCACTCGGGTTTTCGTAG
GCGACAGGGTTAAAGCGCCC -> CGACAGGGTTAAAGCGCCCC
AGCCTCTGGGGAGATAGAAG -> GCCTCTGGGGAGATAGAAGG
AGCTACTAGATATCGAGCGG -> GCTACTAGATATCGAGCGGC
ATCACCCCCCTGTTTGATTC -> TCACCCCCCTGTTTGATTCC
TTAGTACCTTATCGCGTTAC -> TAGTACCTTATCGCGTTACC
CCTTTGGTCGTCATGAGCGG -> CTTTGGTCGTCATGAGCGGG
TAGTACCTTATCGCGTTACC -> AGTACCTTATCGCGTTACCG
GTCACTCGGGTTTTCGTAGA -> TCACTCGGGTTTTCGTAGAA
TATCTAATAGGTGATAGAAA -> ATCTAATAGGTGATAGAAAT
TGAGCGGGTTGGACATAATA -> GAGCGGGTTGGACATAATAG
CACGCTTGGGATTACATTAA -> ACGCTTGGGATTACATTAAT
TAGCTACTAGATATCGAGCG -> AGCTACTAGATATCGAGCGG
TCGAGCTGTAGGTCCCAAGC -> CGAGCTGTAGGTCCCAAGCC
GACCGTGGCTATCCATTATA -> ACCGTGGCTATCCATTATAC
TATTTAAACTTCCGTCACTC -> ATTTAAACTTCCGTCACTCG
GATTCCTAAATCCGTAGTTC -> ATTCCTAAATCCGTAGTTCG
TGCAAGGGAATCTAGGACGT -> GCAAGGGAATCTAGGACGTT
GCCTCTGGGGAGATAGAAGG -> CCTCTGGGGAGATAGAAGGA
AATCCGTAGTTCGAGCTGTA -> ATCCGTAGTTCGAGCTGTAG
TGATTGAGCCAAAGGAGCGG -> GATTGAGCCAAAGGAGCGGA
AAGGAGCGGACATGCTAATT -> AGGAGCGGACATGCTAATTA
GGCGAGCCTTGAAGAAGTTA -> GCGAGCCTTGAAGAAGTTAC
GGCCGTGCTAGCTGACAATC -> GCCGTGCTAGCTGACAATCG
TTTTTGAGTAATCTAAGAAT -> TTTTGAGTAATCTAAGAATA
AGAATAACTGGCCGGAAATC -> GAATAACTGGCCGGAAATCA
ATAATAGTAGGGGCGAGCCT -> TAATAGTAGGGGCGAGCCTT
CGGTAGGGGACCGTGGCTAT -> GGTAGGGGACCGTGGCTATC
GGACATGCTAATTAAGGTTT -> GACATGCTAATTAAGGTTTT
ATAGAAATCTGCTAGAACCC -> TAGAAATCTGCTAGAACCCG
CCTGTTTGATTCCTAAATCC -> CTGTTTGATTCCTAAATCCG
GGGAGTACCCTTCGGTGCTC -> GGAGTACCCTTCGGTGCTCC
GTTATTTAAACTTCCGTCAC -> TTATTTAAACTTCCGTCACT
GCTGTAGGTCCCAAGCCTCT -> CTGTAGGTCCCAAGCCTCTG
ACATTAATTGCGCGACAGGG -> CATTAATTGCGCGACAGGGT
CCGCAAGCTAACTCAAGGCG -> CGCAAGCTAACTCAAGGCGC
CGGGTCGGGTGTACCGTGTC -> GGGTCGGGTGTACCGTGTCG
CGTGCCTTTGAGACATGATT -> GTGCCTTTGAGACATGATTG
TGCGCGACAGGGTTAAAGCG -> GCGCGACAGGGTTAAAGCGC
AACCCGGATAAACCAATTAC -> ACCCGGATAAACCAATTACT
CTTTGCGTGTTCAGGGATTG -> TTTGCGTGTTCAGGGATTGA
AAGGTAGCTACTAGATATCG -> AGGTAGCTACTAGATATCGA
CACCATGGCGTTTCTCGTTA -> ACCATGGCGTTTCTCGTTAT
ACCAAGGTAGCTACTAGATA -> CCAAGGTAGCTACTAGATAT
TGAAGTATAGTAGGCCGTGC -> GAAGTATAGTAGGCCGTGCT
TATCCGTGACAATATGAGCA -> ATCCGTGACAATATGAGCAA
GTAGGGGACCGTGGCTATCC -> TAGGGGACCGTGGCTATCCA
TTCCGTCACTCGGGTTTTCG -> TCCGTCACTCGGGTTTTCGT
CATGATTGAGCCAAAGGAGC -> ATGATTGAGCCAAAGGAGCG
ATACTATGTGGACAACTCAA -> TACTATGTGGACAACTCAAA
CTCAATACCGTGGTCCATAC -> TCAATACCGTGGTCCATACG
CTACTTTTTGAGTAATCTAA -> TACTTTTTGAGTAATCTAAG
ATCTGCTAGAACCCGGATAA -> TCTGCTAGAACCCGGATAAA
ACAATATGAGCAATTCCACG -> CAATATGAGCAATTCCACGG
GAACCCGGATAAACCAATTA -> AACCCGGATAAACCAATTAC
GAGCCTTGAAGAAGTTACTT -> AGCCTTGAAGAAGTTACTTT
TGCTAGCTGACAATCGTAGC -> GCTAGCTGACAATCGTAGCC
GCGTGTTCAGGGATTGAGTA -> CGTGTTCAGGGATTGAGTAT
TCACTCGGGTTTTCGTAGAA -> CACTCGGGTTTTCGTAGAAC
CCTCGATATATACCGTTGTT -> CTCGATATATACCGTTGTTG
ATCCATTATACAGCTTATCT -> TCCATTATACAGCTTATCTA
GTCCGTTATTTAAACTTCCG -> TCCGTTATTTAAACTTCCGT
AGTAATCTAAGAATAACTGG -> GTAATCTAAGAATAACTGGC
TCGCGTTACCGTCTTAGTCG -> CGCGTTACCGTCTTAGTCGT
GCTAGAACCCGGATAAACCA -> CTAGAACCCGGATAAACCAA
TTTGATTCCTAAATCCGTAG -> TTGATTCCTAAATCCGTAGT
GCCGTGCTAGCTGACAATCG -> CCGTGCTAGCTGACAATCGT
TCCGACGTTTCTCCCTTTGG -> CCGACGTTTCTCCCTTTGGT
ATTACATTAATTGCGCGACA -> TTACATTAATTGCGCGACAG
GGCGCCTCACGTGTCACCAT -> GCGCCTCACGTGTCACCATG
TCATGCAAGGGAATCTAGGA -> CATGCAAGGGAATCTAGGAC
GCGCCTCACGTGTCACCATG -> CGCCTCACGTGTCACCATGG
TGGACAACTCAAATGTGTGC -> GGACAACTCAAATGTGTGCA
TGTGATAGCGGGAGTACCCT -> GTGATAGCGGGAGTACCCTT
ACCGTGTCGGTAACTATATG -> CCGTGTCGGTAACTATATGC
CTCTGGCCCGCGGCCGTGCC -> TCTGGCCCGCGGCCGTGCCT
TCCTGTATCGGTAGACGAAT -> CCTGTATCGGTAGACGAATG
ACTTTGCGTGTTCAGGGATT -> CTTTGCGTGTTCAGGGATTG
TCTAATTGACTACAGATGAC -> CTAATTGACTACAGATGACT
GCGGGTTGGACATAATAGTA -> CGGGTTGGACATAATAGTAG
TATAGTAGGCCGTGCTAGCT -> ATAGTAGGCCGTGCTAGCTG
TTCGGTGCTCCATCCAGGCA -> TCGGTGCTCCATCCAGGCAG
TGTCCACATACGTAGACACT -> GTCCACATACGTAGACACTA
CCTCAATACCGTGGTCCATA -> CTCAATACCGTGGTCCATAC
ATAACTGGCCGGAAATCACC -> TAACTGGCCGGAAATCACCC
ACTCGGGTTTTCGTAGAACC -> CTCGGGTTTTCGTAGAACCT
CCATTATACAGCTTATCTAA -> CATTATACAGCTTATCTAAT
TTGGGATTACATTAATTGCG -> TGGGATTACATTAATTGCGC
ACATACGTAGACACTACTTT -> CATACGTAGACACTACTTTT
TTTCGTTGAAACTTCTAATT -> TTCGTTGAAACTTCTAATTG
GACAATCGTAGCCCTCAATA -> ACAATCGTAGCCCTCAATAC
TGACTACAGATGACTGACCT -> GACTACAGATGACTGACCTA
AATCTGCTAGAACCCGGATA -> ATCTGCTAGAACCCGGATAA
GTCCATACGACCGCCTGCGA -> TCCATACGACCGCCTGCGAT
GTACCGTGTCGGTAACTATA -> TACCGTGTCGGTAACTATAT
CCGACGTTTCTCCCTTTGGT -> CGACGTTTCTCCCTTTGGTC
TTGAAGAAGTTACTTTGCGT -> TGAAGAAGTTACTTTGCGTG
TCTAAGAATAACTGGCCGGA -> CTAAGAATAACTGGCCGGAA
ATTGAGTATATCCGCCCGCA -> TTGAGTATATCCGCCCGCAA
CCCAAGCCTCTGGGGAGATA -> CCAAGCCTCTGGGGAGATAG
TCTCGTTATACTATGTGGAC -> CTCGTTATACTATGTGGACA
ATTGAGCCAAAGGAGCGGAC -> TTGAGCCAAAGGAGCGGACA
TATGCTAACGCTGGTATCCG -> ATGCTAACGCTGGTATCCGT
CATGGCGTTTCTCGTTATAC -> ATGGCGTTTCTCGTTATACT
TGACACCAAGGTAGCTACTA -> GACACCAAGGTAGCTACTAG
AATAGTAGGGGCGAGCCTTG -> ATAGTAGGGGCGAGCCTTGA
GTCATGAGCGGGTTGGACAT -> TCATGAGCGGGTTGGACATA
AGGTTTTACGTAATCTTGTG -> GGTTTTACGTAATCTTGTGT
ACAATCGTAGCCCTCAATAC -> CAATCGTAGCCCTCAATACC
GTAGGCCGTGCTAGCTGACA -> TAGGCCGTGCTAGCTGACAA
CGGCATCCGGTAGGGGACCG -> GGCATCCGGTAGGGGACCGT
TTACTTTGCGTGTTCAGGGA -> TACTTTGCGTGTTCAGGGAT
GAAATCTGCTAGAACCCGGA -> AAATCTGCTAGAACCCGGAT
CTGGCCGGAAATCACCCCCC -> TGGCCGGAAATCACCCCCCT
ATTAATTGCGCGACAGGGTT -> TTAATTGCGCGACAGGGTTA
GACATAATAGTAGGGGCGAG -> ACATAATAGTAGGGGCGAGC
GGTCCATACGACCGCCTGCG -> GTCCATACGACCGCCTGCGA
AACCTTTATTCATGCAAGGG -> ACCTTTATTCATGCAAGGGA
CTAGCTGACAATCGTAGCCC -> TAGCTGACAATCGTAGCCCT
GAGTAATCTAAGAATAACTG -> AGTAATCTAAGAATAACTGG
TAATAGGTGATAGAAATCTG -> AATAGGTGATAGAAATCTGC
GAAAAGTTGACCCCACCAAT -> AAAAGTTGACCCCACCAATT
TGCTAATTAAGGTTTTACGT -> GCTAATTAAGGTTTTACGTA
GGTAGACGAATGTCCACATA -> GTAGACGAATGTCCACATAC
CGCCTCACGTGTCACCATGG -> GCCTCACGTGTCACCATGGC
AATGTGTGCACGGGTCGGGT -> ATGTGTGCACGGGTCGGGTG
GGATAAACCAATTACTCTGG -> GATAAACCAATTACTCTGGC
ATAGCGGGAGTACCCTTCGG -> TAGCGGGAGTACCCTTCGGT
AACTATATGCTAACGCTGGT -> ACTATATGCTAACGCTGGTA
GACGTTACGACACGCTTGGG -> ACGTTACGACACGCTTGGGA
CGTGTCGGTAACTATATGCT -> GTGTCGGTAACTATATGCTA
GGACAACTCAAATGTGTGCA -> GACAACTCAAATGTGTGCAC
TCGTTATACTATGTGGACAA -> CGTTATACTATGTGGACAAC
GCTAACTCAAGGCGCCTCAC -> CTAACTCAAGGCGCCTCACG
TAGTCGTGTCCGACGTTTCT -> AGTCGTGTCCGACGTTTCTC
GGTGTACCGTGTCGGTAACT -> GTGTACCGTGTCGGTAACTA
GTGGTCCATACGACCGCCTG -> TGGTCCATACGACCGCCTGC
AGCCTTGAAGAAGTTACTTT -> GCCTTGAAGAAGTTACTTTG
CACTACTTTTTGAGTAATCT -> ACTACTTTTTGAGTAATCTA
AGGGGCGAGCCTTGAAGAAG -> GGGGCGAGCCTTGAAGAAGT
GGGCGAGCCTTGAAGAAGTT -> GGCGAGCCTTGAAGAAGTTA
CTTCGGTGCTCCATCCAGGC -> TTCGGTGCTCCATCCAGGCA
CCAATTAGTACCTTATCGCG -> CAATTAGTACCTTATCGCGT
GGAAATCACCCCCCTGTTTG -> GAAATCACCCCCCTGTTTGA
GTTGAAGTATAGTAGGCCGT -> TTGAAGTATAGTAGGCCGTG
GGATTGATATCGGCATCCGG -> GATTGATATCGGCATCCGGT
CGAGCGGCATACAAGCAGCC -> GAGCGGCATACAAGCAGCCC
CCGTGGTCCATACGACCGCC -> CGTGGTCCATACGACCGCCT
CACATACGTAGACACTACTT -> ACATACGTAGACACTACTTT
ACGTAATCTTGTGTGTGATA -> CGTAATCTTGTGTGTGATAG
TGTTCAGGGATTGAGTATAT -> GTTCAGGGATTGAGTATATC
CCCCACCAATTAGTACCTTA -> CCCACCAATTAGTACCTTAT
AGGCCGTGCTAGCTGACAAT -> GGCCGTGCTAGCTGACAATC
CTCAAATGTGTGCACGGGTC -> TCAAATGTGTGCACGGGTCG
TTCTCGTTATACTATGTGGA -> TCTCGTTATACTATGTGGAC
CGCGACAGGGTTAAAGCGCC -> GCGACAGGGTTAAAGCGCCC
ACGTTTCTCCCTTTGGTCGT -> CGTTTCTCCCTTTGGTCGTC
AATCTAAGAATAACTGGCCG -> ATCTAAGAATAACTGGCCGG
TCTGGGGAGATAGAAGGATT -> CTGGGGAGATAGAAGGATTC
ACCAATTAGTACCTTATCGC -> CCAATTAGTACCTTATCGCG
TCTGGCCCGCGGCCGTGCCT -> CTGGCCCGCGGCCGTGCCTT
TAAGGTTTTACGTAATCTTG -> AAGGTTTTACGTAATCTTGT
TAGACGAATGTCCACATACG -> AGACGAATGTCCACATACGT
AGGAGCGGACATGCTAATTA -> GGAGCGGACATGCTAATTAA
CACCAAGGTAGCTACTAGAT -> ACCAAGGTAGCTACTAGATA
TAGGCCGTGCTAGCTGACAA -> AGGCCGTGCTAGCTGACAAT
GGGATTGAGTATATCCGCCC -> GGATTGAGTATATCCGCCCG
CGCTTGGGATTACATTAATT -> GCTTGGGATTACATTAATTG
GGTGATAGAAATCTGCTAGA -> GTGATAGAAATCTGCTAGAA
CCGTCTTAGTCGTGTCCGAC -> CGTCTTAGTCGTGTCCGACG
GGATTCTCCTCGATATATAC -> GATTCTCCTCGATATATACC
GAAGAAGTTACTTTGCGTGT -> AAGAAGTTACTTTGCGTGTT
TTTCTCGTTATACTATGTGG -> TTCTCGTTATACTATGTGGA
ACACCAAGGTAGCTACTAGA -> CACCAAGGTAGCTACTAGAT
TTATACAGCTTATCTAATAG -> TATACAGCTTATCTAATAGG
GTCAGTCCGTTATTTAAACT -> TCAGTCCGTTATTTAAACTT
CGATACTGTGGAGGCTTAAC -> GATACTGTGGAGGCTTAACT
TCGGTAGACGAATGTCCACA -> CGGTAGACGAATGTCCACAT
TAGATATCGAGCGGCATACA -> AGATATCGAGCGGCATACAA
GTTTCTCGTTATACTATGTG -> TTTCTCGTTATACTATGTGG
GGATTGAGTATATCCGCCCG -> GATTGAGTATATCCGCCCGC
GGCCGTGCCTTTGAGACATG -> GCCGTGCCTTTGAGACATGA
TCTTGTGTGTGATAGCGGGA -> CTTGTGTGTGATAGCGGGAG
TAAACCAATTACTCTGGCCC -> AAACCAATTACTCTGGCCCG
GGGAATCTAGGACGTTACGA -> GGAATCTAGGACGTTACGAC
ATTTCGTCAGTCCGTTATTT -> TTTCGTCAGTCCGTTATTTA
TCACGTGTCACCATGGCGTT -> CACGTGTCACCATGGCGTTT
CGTAGACACTACTTTTTGAG -> GTAGACACTACTTTTTGAGT
TACGACCGCCTGCGATACTG -> ACGACCGCCTGCGATACTGT
GGGGAGATAGAAGGATTCTC -> GGGAGATAGAAGGATTCTCC
GTTATACTATGTGGACAACT -> TTATACTATGTGGACAACTC
TGAAAAGTTGACCCCACCAA -> GAAAAGTTGACCCCACCAAT
TATCCATTATACAGCTTATC -> ATCCATTATACAGCTTATCT
GCCTGCGATACTGTGGAGGC -> CCTGCGATACTGTGGAGGCT
GGGATTGATATCGGCATCCG -> GGATTGATATCGGCATCCGG
GCGGACATGCTAATTAAGGT -> CGGACATGCTAATTAAGGTT
TTAAGGTTTTACGTAATCTT -> TAAGGTTTTACGTAATCTTG
TGACAATATGAGCAATTCCA -> GACAATATGAGCAATTCCAC
CTTCTAATTGACTACAGATG -> TTCTAATTGACTACAGATGA
AAGCCTCTGGGGAGATAGAA -> AGCCTCTGGGGAGATAGAAG
CCCCATTGTGAAAAGTTGAC -> CCCATTGTGAAAAGTTGACC
TATATACCGTTGTTGAAGTA -> ATATACCGTTGTTGAAGTAT
GGCTTAACTAAATTTCGTCA -> GCTTAACTAAATTTCGTCAG
ATCTTGTGTGTGATAGCGGG -> TCTTGTGTGTGATAGCGGGA
GAAGTATAGTAGGCCGTGCT -> AAGTATAGTAGGCCGTGCTA
GCAATTCCACGGGATTGATA -> CAATTCCACGGGATTGATAT
TAGGACGTTACGACACGCTT -> AGGACGTTACGACACGCTTG
CGGACATGCTAATTAAGGTT -> GGACATGCTAATTAAGGTTT
TTACGTAATCTTGTGTGTGA -> TACGTAATCTTGTGTGTGAT
AATTGACTACAGATGACTGA -> ATTGACTACAGATGACTGAC
GATAGAAATCTGCTAGAACC -> ATAGAAATCTGCTAGAACCC
TGTATCGGTAGACGAATGTC -> GTATCGGTAGACGAATGTCC
ACCCCCCTGTTTGATTCCTA -> CCCCCCTGTTTGATTCCTAA
GACCGCCTGCGATACTGTGG -> ACCGCCTGCGATACTGTGGA
AAGTTACTTTGCGTGTTCAG -> AGTTACTTTGCGTGTTCAGG
ATAGGTGATAGAAATCTGCT -> TAGGTGATAGAAATCTGCTA
TGTCCGACGTTTCTCCCTTT -> GTCCGACGTTTCTCCCTTTG
TCTCCCTTTGGTCGTCATGA -> CTCCCTTTGGTCGTCATGAG
CGGCCGTGCCTTTGAGACAT -> GGCCGTGCCTTTGAGACATG
ATCCGGTAGGGGACCGTGGC -> TCCGGTAGGGGACCGTGGCT
GACATGATTGAGCCAAAGGA -> ACATGATTGAGCCAAAGGAG
GGTCGGGTGTACCGTGTCGG -> GTCGGGTGTACCGTGTCGGT
ATCGCGTTACCGTCTTAGTC -> TCGCGTTACCGTCTTAGTCG
GCTAGCTGACAATCGTAGCC -> CTAGCTGACAATCGTAGCCC
CGTAATCTTGTGTGTGATAG -> GTAATCTTGTGTGTGATAGC
TGTGCACGGGTCGGGTGTAC -> GTGCACGGGTCGGGTGTACC
CCGTAGTTCGAGCTGTAGGT -> CGTAGTTCGAGCTGTAGGTC
TTCCACGGGATTGATATCGG -> TCCACGGGATTGATATCGGC
ATTCCTAAATCCGTAGTTCG -> TTCCTAAATCCGTAGTTCGA
TTCTAATTGACTACAGATGA -> TCTAATTGACTACAGATGAC
AAATCACCCCCCTGTTTGAT -> AATCACCCCCCTGTTTGATT
TTCGTCAGTCCGTTATTTAA -> TCGTCAGTCCGTTATTTAAA
AGCTAACTCAAGGCGCCTCA -> GCTAACTCAAGGCGCCTCAC
GCCCGCAAGCTAACTCAAGG -> CCCGCAAGCTAACTCAAGGC
ATTCATGCAAGGGAATCTAG -> TTCATGCAAGGGAATCTAGG
TGTAGGTCCCAAGCCTCTGG -> GTAGGTCCCAAGCCTCTGGG
AGTAGGGGCGAGCCTTGAAG -> GTAGGGGCGAGCCTTGAAGA
ATACCGTGGTCCATACGACC -> TACCGTGGTCCATACGACCG
GCTTAACTAAATTTCGTCAG -> CTTAACTAAATTTCGTCAGT
TTAACTAAATTTCGTCAGTC -> TAACTAAATTTCGTCAGTCC
AACTTCTAATTGACTACAGA -> ACTTCTAATTGACTACAGAT
TGTACCGTGTCGGTAACTAT -> GTACCGTGTCGGTAACTATA
CTCCTGTATCGGTAGACGAA -> TCCTGTATCGGTAGACGAAT
GTAGTTCGAGCTGTAGGTCC -> TAGTTCGAGCTGTAGGTCCC
GTATCCGTGACAATATGAGC -> TATCCGTGACAATATGAGCA
ATCTAAGAATAACTGGCCGG -> TCTAAGAATAACTGGCCGGA
ATCTAGGACGTTACGACACG -> TCTAGGACGTTACGACACGC
GTAGCTACTAGATATCGAGC -> TAGCTACTAGATATCGAGCG
CCCGGATAAACCAATTACTC -> CCGGATAAACCAATTACTCT
GCAGCCCTCCTGTATCGGTA -> CAGCCCTCCTGTATCGGTAG
GTTTTACGTAATCTTGTGTG -> TTTTACGTAATCTTGTGTGT
CCCTTTGGTCGTCATGAGCG -> CCTTTGGTCGTCATGAGCGG
GGATTACATTAATTGCGCGA -> GATTACATTAATTGCGCGAC
TACCGTTGTTGAAGTATAGT -> ACCGTTGTTGAAGTATAGTA
TCAGTCCGTTATTTAAACTT -> CAGTCCGTTATTTAAACTTC
ATACTGTGGAGGCTTAACTA -> TACTGTGGAGGCTTAACTAA
GTCGTGTCCGACGTTTCTCC -> TCGTGTCCGACGTTTCTCCC
AGGTGATAGAAATCTGCTAG -> GGTGATAGAAATCTGCTAGA
GTAGACGAATGTCCACATAC -> TAGACGAATGTCCACATACG
GGGTTGGACATAATAGTAGG -> GGTTGGACATAATAGTAGGG
CGTGCTAGCTGACAATCGTA -> GTGCTAGCTGACAATCGTAG
CTGCTAGAACCCGGATAAAC -> TGCTAGAACCCGGATAAACC
AAGGGAATCTAGGACGTTAC -> AGGGAATCTAGGACGTTACG
GCCCTCAATACCGTGGTCCA -> CCCTCAATACCGTGGTCCAT
TACCGTGTCGGTAACTATAT -> ACCGTGTCGGTAACTATATG
ATCGGTAGACGAATGTCCAC -> TCGGTAGACGAATGTCCACA
TGTGGACAACTCAAATGTGT -> GTGGACAACTCAAATGTGTG
TAGGTCCCAAGCCTCTGGGG -> AGGTCCCAAGCCTCTGGGGA
AGAAGTTACTTTGCGTGTTC -> GAAGTTACTTTGCGTGTTCA
AGCGGCATACAAGCAGCCCT -> GCGGCATACAAGCAGCCCTC
ATTGCGCGACAGGGTTAAAG -> TTGCGCGACAGGGTTAAAGC
GGCGTTTCTCGTTATACTAT -> GCGTTTCTCGTTATACTATG
AATTTCGTCAGTCCGTTATT -> ATTTCGTCAGTCCGTTATTT
GGCCCGCGGCCGTGCCTTTG -> GCCCGCGGCCGTGCCTTTGA
CTAGGACGTTACGACACGCT -> TAGGACGTTACGACACGCTT
GTTGGACATAATAGTAGGGG -> TTGGACATAATAGTAGGGGC
TGGACATAATAGTAGGGGCG -> GGACATAATAGTAGGGGCGA
GGAATCTAGGACGTTACGAC -> GAATCTAGGACGTTACGACA
GTGACAATATGAGCAATTCC -> TGACAATATGAGCAATTCCA
CGCCCGCAAGCTAACTCAAG -> GCCCGCAAGCTAACTCAAGG
CTATATGCTAACGCTGGTAT -> TATATGCTAACGCTGGTATC
TACAAGCAGCCCTCCTGTAT -> ACAAGCAGCCCTCCTGTATC
TTGTGTGTGATAGCGGGAGT -> TGTGTGTGATAGCGGGAGTA
ATATCCGCCCGCAAGCTAAC -> TATCCGCCCGCAAGCTAACT
AAATCCGTAGTTCGAGCTGT -> AATCCGTAGTTCGAGCTGTA
TATACAGCTTATCTAATAGG -> ATACAGCTTATCTAATAGGT
TTTTGAGTAATCTAAGAATA -> TTTGAGTAATCTAAGAATAA
CTTGGGATTACATTAATTGC -> TTGGGATTACATTAATTGCG
ATGAGCGGGTTGGACATAAT -> TGAGCGGGTTGGACATAATA
TGCACGGGTCGGGTGTACCG -> GCACGGGTCGGGTGTACCGT
CCGGTAGGGGACCGTGGCTA -> CGGTAGGGGACCGTGGCTAT
GAGCGGCATACAAGCAGCCC -> AGCGGCATACAAGCAGCCCT
GGGGACCGTGGCTATCCATT -> GGGACCGTGGCTATCCATTA
GCTAATTAAGGTTTTACGTA -> CTAATTAAGGTTTTACGTAA
CCGTGGCTATCCATTATACA -> CGTGGCTATCCATTATACAG
TAGAAATCTGCTAGAACCCG -> AGAAATCTGCTAGAACCCGG
TAGAAGGATTCTCCTCGATA -> AGAAGGATTCTCCTCGATAT
AAACCAATTACTCTGGCCCG -> AACCAATTACTCTGGCCCGC
ACCGTCTTAGTCGTGTCCGA -> CCGTCTTAGTCGTGTCCGAC
AAGTATAGTAGGCCGTGCTA -> AGTATAGTAGGCCGTGCTAG
CCCATTGTGAAAAGTTGACC -> CCATTGTGAAAAGTTGACCC
TAATCTTGTGTGTGATAGCG -> AATCTTGTGTGTGATAGCGG
GATAAACCAATTACTCTGGC -> ATAAACCAATTACTCTGGCC
TCCCTTTGGTCGTCATGAGC -> CCCTTTGGTCGTCATGAGCG
ACCCGGATAAACCAATTACT -> CCCGGATAAACCAATTACTC
CCTAAATCCGTAGTTCGAGC -> CTAAATCCGTAGTTCGAGCT
AGGTCCCAAGCCTCTGGGGA -> GGTCCCAAGCCTCTGGGGAG
GACAACTCAAATGTGTGCAC -> ACAACTCAAATGTGTGCACG
CGTGTCCGACGTTTCTCCCT -> GTGTCCGACGTTTCTCCCTT
CCTCCTGTATCGGTAGACGA -> CTCCTGTATCGGTAGACGAA
GCCCGCGGCCGTGCCTTTGA -> CCCGCGGCCGTGCCTTTGAG
GGTATCCGTGACAATATGAG -> GTATCCGTGACAATATGAGC
CCCTCCTGTATCGGTAGACG -> CCTCCTGTATCGGTAGACGA
GAGCGGACATGCTAATTAAG -> AGCGGACATGCTAATTAAGG
TCCTAAATCCGTAGTTCGAG -> CCTAAATCCGTAGTTCGAGC
CTAAGAATAACTGGCCGGAA -> TAAGAATAACTGGCCGGAAA
CTGTATCGGTAGACGAATGT -> TGTATCGGTAGACGAATGTC
AAGAAGTTACTTTGCGTGTT -> AGAAGTTACTTTGCGTGTTC
TGGCTATCCATTATACAGCT -> GGCTATCCATTATACAGCTT
CTCAAGGCGCCTCACGTGTC -> TCAAGGCGCCTCACGTGTCA
CCTTATCGCGTTACCGTCTT -> CTTATCGCGTTACCGTCTTA
TTCCTAAATCCGTAGTTCGA -> TCCTAAATCCGTAGTTCGAG
CGTTTCTCCCTTTGGTCGTC -> GTTTCTCCCTTTGGTCGTCA
GTAATCTTGTGTGTGATAGC -> TAATCTTGTGTGTGATAGCG
TGACTGACCTAGTGACACCA -> GACTGACCTAGTGACACCAA
AATCGTAGCCCTCAATACCG -> ATCGTAGCCCTCAATACCGT
CATTAATTGCGCGACAGGGT -> ATTAATTGCGCGACAGGGTT
TGCGATACTGTGGAGGCTTA -> GCGATACTGTGGAGGCTTAA
GTGATAGAAATCTGCTAGAA -> TGATAGAAATCTGCTAGAAC
CCATTGTGAAAAGTTGACCC -> CATTGTGAAAAGTTGACCCC
TCATGAGCGGGTTGGACATA -> CATGAGCGGGTTGGACATAA
CTCCTCGATATATACCGTTG -> TCCTCGATATATACCGTTGT
CAAGCTAACTCAAGGCGCCT -> AAGCTAACTCAAGGCGCCTC
GATTGAGTATATCCGCCCGC -> ATTGAGTATATCCGCCCGCA
GGCATCCGGTAGGGGACCGT -> GCATCCGGTAGGGGACCGTG
TCGTTGAAACTTCTAATTGA -> CGTTGAAACTTCTAATTGAC
CGCGGCCGTGCCTTTGAGAC -> GCGGCCGTGCCTTTGAGACA
TAGGTGATAGAAATCTGCTA -> AGGTGATAGAAATCTGCTAG
TTGATTCCTAAATCCGTAGT -> TGATTCCTAAATCCGTAGTT
AACGCTGGTATCCGTGACAA -> ACGCTGGTATCCGTGACAAT
CGTCTTAGTCGTGTCCGACG -> GTCTTAGTCGTGTCCGACGT
CACGTGTCACCATGGCGTTT -> ACGTGTCACCATGGCGTTTC
CAAGGTAGCTACTAGATATC -> AAGGTAGCTACTAGATATCG
TATGTGGACAACTCAAATGT -> ATGTGGACAACTCAAATGTG
TACTTTTTGAGTAATCTAAG -> ACTTTTTGAGTAATCTAAGA
CTAGAACCCGGATAAACCAA -> TAGAACCCGGATAAACCAAT
CAATACCGTGGTCCATACGA -> AATACCGTGGTCCATACGAC
GAGCCAAAGGAGCGGACATG -> AGCCAAAGGAGCGGACATGC
TGGGATTACATTAATTGCGC -> GGGATTACATTAATTGCGCG
GTTTGATTCCTAAATCCGTA -> TTTGATTCCTAAATCCGTAG
ATACAGCTTATCTAATAGGT -> TACAGCTTATCTAATAGGTG
CAATCGTAGCCCTCAATACC -> AATCGTAGCCCTCAATACCG
AGATAGAAGGATTCTCCTCG -> GATAGAAGGATTCTCCTCGA
AAAGGAGCGGACATGCTAAT -> AAGGAGCGGACATGCTAATT
ATGCTAACGCTGGTATCCGT -> TGCTAACGCTGGTATCCGTG
AATTAGTACCTTATCGCGTT -> ATTAGTACCTTATCGCGTTA
GAATAACTGGCCGGAAATCA -> AATAACTGGCCGGAAATCAC
ATGTGTGCACGGGTCGGGTG -> TGTGTGCACGGGTCGGGTGT
TTGAGTATATCCGCCCGCAA -> TGAGTATATCCGCCCGCAAG
CTTGAAGAAGTTACTTTGCG -> TTGAAGAAGTTACTTTGCGT
TTGACTACAGATGACTGACC -> TGACTACAGATGACTGACCT
TTGAGCCAAAGGAGCGGACA -> TGAGCCAAAGGAGCGGACAT
AATAGGTGATAGAAATCTGC -> ATAGGTGATAGAAATCTGCT
TATCGGTAGACGAATGTCCA -> ATCGGTAGACGAATGTCCAC
CGTTACCGTCTTAGTCGTGT -> GTTACCGTCTTAGTCGTGTC
GTGTTCAGGGATTGAGTATA -> TGTTCAGGGATTGAGTATAT
ATCCGCCCGCAAGCTAACTC -> TCCGCCCGCAAGCTAACTCA
ATGGCGTTTCTCGTTATACT -> TGGCGTTTCTCGTTATACTA
GTACCCTTCGGTGCTCCATC -> TACCCTTCGGTGCTCCATCC
ACAAGCAGCCCTCCTGTATC -> CAAGCAGCCCTCCTGTATCG
CGTGGTCCATACGACCGCCT -> GTGGTCCATACGACCGCCTG
CACGGGTCGGGTGTACCGTG -> ACGGGTCGGGTGTACCGTGT
CGGTAACTATATGCTAACGC -> GGTAACTATATGCTAACGCT
CGGTAGACGAATGTCCACAT -> GGTAGACGAATGTCCACATA
TACCCTTCGGTGCTCCATCC -> ACCCTTCGGTGCTCCATCCA
TTACATTAATTGCGCGACAG -> TACATTAATTGCGCGACAGG
TTGAAACTTCTAATTGACTA -> TGAAACTTCTAATTGACTAC
ACTGACCTAGTGACACCAAG -> CTGACCTAGTGACACCAAGG
GGTCGTCATGAGCGGGTTGG -> GTCGTCATGAGCGGGTTGGA
TACAGATGACTGACCTAGTG -> ACAGATGACTGACCTAGTGA
ATTTAAACTTCCGTCACTCG -> TTTAAACTTCCGTCACTCGG
ATCGAGCGGCATACAAGCAG -> TCGAGCGGCATACAAGCAGC
ATATGAGCAATTCCACGGGA -> TATGAGCAATTCCACGGGAT
CGTGGCTATCCATTATACAG -> GTGGCTATCCATTATACAGC
GGTCCCAAGCCTCTGGGGAG -> GTCCCAAGCCTCTGGGGAGA
CGAGCTGTAGGTCCCAAGCC -> GAGCTGTAGGTCCCAAGCCT
TATCCGCCCGCAAGCTAACT -> ATCCGCCCGCAAGCTAACTC
CTATCCATTATACAGCTTAT -> TATCCATTATACAGCTTATC
CGTCATGAGCGGGTTGGACA -> GTCATGAGCGGGTTGGACAT
AGCAATTCCACGGGATTGAT -> GCAATTCCACGGGATTGATA
CATACGTAGACACTACTTTT -> ATACGTAGACACTACTTTTT
TCCATTATACAGCTTATCTA -> CCATTATACAGCTTATCTAA
ACGCTTGGGATTACATTAAT -> CGCTTGGGATTACATTAATT
AAGCAGCCCTCCTGTATCGG -> AGCAGCCCTCCTGTATCGGT
TCTTAGTCGTGTCCGACGTT -> CTTAGTCGTGTCCGACGTTT
TAATCTAAGAATAACTGGCC -> AATCTAAGAATAACTGGCCG
GATAGCGGGAGTACCCTTCG -> ATAGCGGGAGTACCCTTCGG
CCGCCTGCGATACTGTGGAG -> CGCCTGCGATACTGTGGAGG
ACTTTTTGAGTAATCTAAGA -> CTTTTTGAGTAATCTAAGAA
ACCGTGGTCCATACGACCGC -> CCGTGGTCCATACGACCGCC
CGCAAGCTAACTCAAGGCGC -> GCAAGCTAACTCAAGGCGCC
TGTGGAGGCTTAACTAAATT -> GTGGAGGCTTAACTAAATTT
TTAGTCGTGTCCGACGTTTC -> TAGTCGTGTCCGACGTTTCT
CAGATGACTGACCTAGTGAC -> AGATGACTGACCTAGTGACA
GTGCCTTTGAGACATGATTG -> TGCCTTTGAGACATGATTGA
AGCTGTAGGTCCCAAGCCTC -> GCTGTAGGTCCCAAGCCTCT
CGGGTGTACCGTGTCGGTAA -> GGGTGTACCGTGTCGGTAAC
TTTATTCATGCAAGGGAATC -> TTATTCATGCAAGGGAATCT
TCCGCCCGCAAGCTAACTCA -> CCGCCCGCAAGCTAACTCAA
TTTAAACTTCCGTCACTCGG -> TTAAACTTCCGTCACTCGGG
GCTGGTATCCGTGACAATAT -> CTGGTATCCGTGACAATATG
GTAGGGGCGAGCCTTGAAGA -> TAGGGGCGAGCCTTGAAGAA
CGACGTTTCTCCCTTTGGTC -> GACGTTTCTCCCTTTGGTCG
CCCCCCTGTTTGATTCCTAA -> CCCCCTGTTTGATTCCTAAA
GTGTCGGTAACTATATGCTA -> TGTCGGTAACTATATGCTAA
AGGTAGCTACTAGATATCGA -> GGTAGCTACTAGATATCGAG
GTCACCATGGCGTTTCTCGT -> TCACCATGGCGTTTCTCGTT
AGGGTTAAAGCGCCCCATTG -> GGGTTAAAGCGCCCCATTGT
ACCCTTCGGTGCTCCATCCA -> CCCTTCGGTGCTCCATCCAG
GGACCGTGGCTATCCATTAT -> GACCGTGGCTATCCATTATA
GTTTCTCCCTTTGGTCGTCA -> TTTCTCCCTTTGGTCGTCAT
AATTCCACGGGATTGATATC -> ATTCCACGGGATTGATATCG
CATGCAAGGGAATCTAGGAC -> ATGCAAGGGAATCTAGGACG
ATATCGGCATCCGGTAGGGG -> TATCGGCATCCGGTAGGGGA
GCCCCATTGTGAAAAGTTGA -> CCCCATTGTGAAAAGTTGAC
AATAACTGGCCGGAAATCAC -> ATAACTGGCCGGAAATCACC
TCCACGGGATTGATATCGGC -> CCACGGGATTGATATCGGCA
CCTTGAAGAAGTTACTTTGC -> CTTGAAGAAGTTACTTTGCG
ACTATGTGGACAACTCAAAT -> CTATGTGGACAACTCAAATG
CGTTATTTAAACTTCCGTCA -> GTTATTTAAACTTCCGTCAC
GTCCACATACGTAGACACTA -> TCCACATACGTAGACACTAC
ACCGTTGTTGAAGTATAGTA -> CCGTTGTTGAAGTATAGTAG
AGCCCTCCTGTATCGGTAGA -> GCCCTCCTGTATCGGTAGAC
TGCCTTTGAGACATGATTGA -> GCCTTTGAGACATGATTGAG
TAACTGGCCGGAAATCACCC -> AACTGGCCGGAAATCACCCC
CGTTATACTATGTGGACAAC -> GTTATACTATGTGGACAACT
GCTTGGGATTACATTAATTG -> CTTGGGATTACATTAATTGC
ACCTTTATTCATGCAAGGGA -> CCTTTATTCATGCAAGGGAA
AGAACCCGGATAAACCAATT -> GAACCCGGATAAACCAATTA
CCCCTGTTTGATTCCTAAAT -> CCCTGTTTGATTCCTAAATC
TCGGGTTTTCGTAGAACCTT -> CGGGTTTTCGTAGAACCTTT
CGACCGCCTGCGATACTGTG -> GACCGCCTGCGATACTGTGG
TACCGTCTTAGTCGTGTCCG -> ACCGTCTTAGTCGTGTCCGA
ATGATTGAGCCAAAGGAGCG -> TGATTGAGCCAAAGGAGCGG
CTTTATTCATGCAAGGGAAT -> TTTATTCATGCAAGGGAATC
CGTTGAAACTTCTAATTGAC -> GTTGAAACTTCTAATTGACT
AAATGTGTGCACGGGTCGGG -> AATGTGTGCACGGGTCGGGT
ACAACTCAAATGTGTGCACG -> CAACTCAAATGTGTGCACGG
TGAGACATGATTGAGCCAAA -> GAGACATGATTGAGCCAAAG
CACTCGGGTTTTCGTAGAAC -> ACTCGGGTTTTCGTAGAACC
GCCTTGAAGAAGTTACTTTG -> CCTTGAAGAAGTTACTTTGC
TTGAGACATGATTGAGCCAA -> TGAGACATGATTGAGCCAAA
ACTTCTAATTGACTACAGAT -> CTTCTAATTGACTACAGATG
TCGTCAGTCCGTTATTTAAA -> CGTCAGTCCGTTATTTAAAC
CCGCCCGCAAGCTAACTCAA -> CGCCCGCAAGCTAACTCAAG
GGGACCGTGGCTATCCATTA -> GGACCGTGGCTATCCATTAT
CTCGTTATACTATGTGGACA -> TCGTTATACTATGTGGACAA
TCGTCATGAGCGGGTTGGAC -> CGTCATGAGCGGGTTGGACA
TTATCTAATAGGTGATAGAA -> TATCTAATAGGTGATAGAAA
CAGGGATTGAGTATATCCGC -> AGGGATTGAGTATATCCGCC
ATAGTAGGCCGTGCTAGCTG -> TAGTAGGCCGTGCTAGCTGA
TACTATGTGGACAACTCAAA -> ACTATGTGGACAACTCAAAT
AATCTTGTGTGTGATAGCGG -> ATCTTGTGTGTGATAGCGGG
AGCAGCCCTCCTGTATCGGT -> GCAGCCCTCCTGTATCGGTA
CATTGTGAAAAGTTGACCCC -> ATTGTGAAAAGTTGACCCCA
AGGACGTTACGACACGCTTG -> GGACGTTACGACACGCTTGG
ATGAGCAATTCCACGGGATT -> TGAGCAATTCCACGGGATTG
TTACCGTCTTAGTCGTGTCC -> TACCGTCTTAGTCGTGTCCG
ATCGTAGCCCTCAATACCGT -> TCGTAGCCCTCAATACCGTG
GACAATATGAGCAATTCCAC -> ACAATATGAGCAATTCCACG
TGGCGTTTCTCGTTATACTA -> GGCGTTTCTCGTTATACTAT
CAACTCAAATGTGTGCACGG -> AACTCAAATGTGTGCACGGG
AAATTTCGTCAGTCCGTTAT -> AATTTCGTCAGTCCGTTATT
TAGTAGGGGCGAGCCTTGAA -> AGTAGGGGCGAGCCTTGAAG
GAGCAATTCCACGGGATTGA -> AGCAATTCCACGGGATTGAT
AGACATGATTGAGCCAAAGG -> GACATGATTGAGCCAAAGGA
CGGAAATCACCCCCCTGTTT -> GGAAATCACCCCCCTGTTTG
ACTAAATTTCGTCAGTCCGT -> CTAAATTTCGTCAGTCCGTT
CTCGGGTTTTCGTAGAACCT -> TCGGGTTTTCGTAGAACCTT
CGTCAGTCCGTTATTTAAAC -> GTCAGTCCGTTATTTAAACT
TGGTCCATACGACCGCCTGC -> GGTCCATACGACCGCCTGCG
GAAACTTCTAATTGACTACA -> AAACTTCTAATTGACTACAG
ATACAAGCAGCCCTCCTGTA -> TACAAGCAGCCCTCCTGTAT
TTAAAGCGCCCCATTGTGAA -> TAAAGCGCCCCATTGTGAAA
GATATCGAGCGGCATACAAG -> ATATCGAGCGGCATACAAGC
GCTGACAATCGTAGCCCTCA -> CTGACAATCGTAGCCCTCAA
CGCTGGTATCCGTGACAATA -> GCTGGTATCCGTGACAATAT
GTAGAACCTTTATTCATGCA -> TAGAACCTTTATTCATGCAA
ACATAATAGTAGGGGCGAGC -> CATAATAGTAGGGGCGAGCC
GGGTTTTCGTAGAACCTTTA -> GGTTTTCGTAGAACCTTTAT
TGATAGCGGGAGTACCCTTC -> GATAGCGGGAGTACCCTTCG
GTAACTATATGCTAACGCTG -> TAACTATATGCTAACGCTGG
ATACGACCGCCTGCGATACT -> TACGACCGCCTGCGATACTG
CTATGTGGACAACTCAAATG -> TATGTGGACAACTCAAATGT
CCGTTGTTGAAGTATAGTAG -> CGTTGTTGAAGTATAGTAGG
AACTCAAGGCGCCTCACGTG -> ACTCAAGGCGCCTCACGTGT
TTACTCTGGCCCGCGGCCGT -> TACTCTGGCCCGCGGCCGTG
TGGTATCCGTGACAATATGA -> GGTATCCGTGACAATATGAG
GCGGCCGTGCCTTTGAGACA -> CGGCCGTGCCTTTGAGACAT
TAACTCAAGGCGCCTCACGT -> AACTCAAGGCGCCTCACGTG
TGTCACCATGGCGTTTCTCG -> GTCACCATGGCGTTTCTCGT
CTTTGGTCGTCATGAGCGGG -> TTTGGTCGTCATGAGCGGGT
CTGTGGAGGCTTAACTAAAT -> TGTGGAGGCTTAACTAAATT
AAAGTTGACCCCACCAATTA -> AAGTTGACCCCACCAATTAG
TAGACACTACTTTTTGAGTA -> AGACACTACTTTTTGAGTAA
GCATCCGGTAGGGGACCGTG -> CATCCGGTAGGGGACCGTGG
CAATTAGTACCTTATCGCGT -> AATTAGTACCTTATCGCGTT
GAGTATATCCGCCCGCAAGC -> AGTATATCCGCCCGCAAGCT
TTCGTTGAAACTTCTAATTG -> TCGTTGAAACTTCTAATTGA
TCTAGGACGTTACGACACGC -> CTAGGACGTTACGACACGCT
ATTAGTACCTTATCGCGTTA -> TTAGTACCTTATCGCGTTAC
GCAAGCTAACTCAAGGCGCC -> CAAGCTAACTCAAGGCGCCT
CTGCGATACTGTGGAGGCTT -> TGCGATACTGTGGAGGCTTA
GGTAACTATATGCTAACGCT -> GTAACTATATGCTAACGCTG
GCGTTACCGTCTTAGTCGTG -> CGTTACCGTCTTAGTCGTGT
ACGTGTCACCATGGCGTTTC -> CGTGTCACCATGGCGTTTCT
TTTTACGTAATCTTGTGTGT -> TTTACGTAATCTTGTGTGTG
TCGATATATACCGTTGTTGA -> CGATATATACCGTTGTTGAA
GGAGTACCCTTCGGTGCTCC -> GAGTACCCTTCGGTGCTCCA
ACCAATTACTCTGGCCCGCG -> CCAATTACTCTGGCCCGCGG
AAACTTCTAATTGACTACAG -> AACTTCTAATTGACTACAGA
CACCCCCCTGTTTGATTCCT -> ACCCCCCTGTTTGATTCCTA
GTGAAAAGTTGACCCCACCA -> TGAAAAGTTGACCCCACCAA
AAGAATAACTGGCCGGAAAT -> AGAATAACTGGCCGGAAATC
GTAGGTCCCAAGCCTCTGGG -> TAGGTCCCAAGCCTCTGGGG
GTGGAGGCTTAACTAAATTT -> TGGAGGCTTAACTAAATTTC
ACAGATGACTGACCTAGTGA -> CAGATGACTGACCTAGTGAC
TGGGGAGATAGAAGGATTCT -> GGGGAGATAGAAGGATTCTC
TAGAACCCGGATAAACCAAT -> AGAACCCGGATAAACCAATT
GGCTATCCATTATACAGCTT -> GCTATCCATTATACAGCTTA
CTAATTAAGGTTTTACGTAA -> TAATTAAGGTTTTACGTAAT
TAGGGGCGAGCCTTGAAGAA -> AGGGGCGAGCCTTGAAGAAG
AAATCTGCTAGAACCCGGAT -> AATCTGCTAGAACCCGGATA
GTAGCCCTCAATACCGTGGT -> TAGCCCTCAATACCGTGGTC
CTCACGTGTCACCATGGCGT -> TCACGTGTCACCATGGCGTT
AGTTGACCCCACCAATTAGT -> GTTGACCCCACCAATTAGTA
TCCGTCACTCGGGTTTTCGT -> CCGTCACTCGGGTTTTCGTA
GACAGGGTTAAAGCGCCCCA -> ACAGGGTTAAAGCGCCCCAT
GGGAGATAGAAGGATTCTCC -> GGAGATAGAAGGATTCTCCT
CAGGGTTAAAGCGCCCCATT -> AGGGTTAAAGCGCCCCATTG
TTTCTCCCTTTGGTCGTCAT -> TTCTCCCTTTGGTCGTCATG
GTAGACACTACTTTTTGAGT -> TAGACACTACTTTTTGAGTA
TACTAGATATCGAGCGGCAT -> ACTAGATATCGAGCGGCATA
AGTATAGTAGGCCGTGCTAG -> GTATAGTAGGCCGTGCTAGC
ACGTTACGACACGCTTGGGA -> CGTTACGACACGCTTGGGAT
TTTCGTAGAACCTTTATTCA -> TTCGTAGAACCTTTATTCAT
ATACCGTTGTTGAAGTATAG -> TACCGTTGTTGAAGTATAGT
TACGACACGCTTGGGATTAC -> ACGACACGCTTGGGATTACA
CGTTACGACACGCTTGGGAT -> GTTACGACACGCTTGGGATT
CGCCTGCGATACTGTGGAGG -> GCCTGCGATACTGTGGAGGC
AGCGGGAGTACCCTTCGGTG -> GCGGGAGTACCCTTCGGTGC
GACACTACTTTTTGAGTAAT -> ACACTACTTTTTGAGTAATC
TAAATTTCGTCAGTCCGTTA -> AAATTTCGTCAGTCCGTTAT
TGATTCCTAAATCCGTAGTT -> GATTCCTAAATCCGTAGTTC
GTGACACCAAGGTAGCTACT -> TGACACCAAGGTAGCTACTA
GCGGCATACAAGCAGCCCTC -> CGGCATACAAGCAGCCCTCC
GGAGATAGAAGGATTCTCCT -> GAGATAGAAGGATTCTCCTC
ACGACACGCTTGGGATTACA -> CGACACGCTTGGGATTACAT
GAGATAGAAGGATTCTCCTC -> AGATAGAAGGATTCTCCTCG
AAGGTTTTACGTAATCTTGT -> AGGTTTTACGTAATCTTGTG
TAATTGACTACAGATGACTG -> AATTGACTACAGATGACTGA
CCGGAAATCACCCCCCTGTT -> CGGAAATCACCCCCCTGTTT
CCTGCGATACTGTGGAGGCT -> CTGCGATACTGTGGAGGCTT
TGATAGAAATCTGCTAGAAC -> GATAGAAATCTGCTAGAACC
TACGTAGACACTACTTTTTG -> ACGTAGACACTACTTTTTGA
ACCTAGTGACACCAAGGTAG -> CCTAGTGACACCAAGGTAGC
AGATGACTGACCTAGTGACA -> GATGACTGACCTAGTGACAC
TCAATACCGTGGTCCATACG -> CAATACCGTGGTCCATACGA
TCAAGGCGCCTCACGTGTCA -> CAAGGCGCCTCACGTGTCAC
CTTAGTCGTGTCCGACGTTT -> TTAGTCGTGTCCGACGTTTC
TGACAATCGTAGCCCTCAAT -> GACAATCGTAGCCCTCAATA
TAATTGCGCGACAGGGTTAA -> AATTGCGCGACAGGGTTAAA
GCCTCACGTGTCACCATGGC -> CCTCACGTGTCACCATGGCG
CTCGATATATACCGTTGTTG -> TCGATATATACCGTTGTTGA
TCTGCTAGAACCCGGATAAA -> CTGCTAGAACCCGGATAAAC
CTGGCCCGCGGCCGTGCCTT -> TGGCCCGCGGCCGTGCCTTT
ACTCTGGCCCGCGGCCGTGC -> CTCTGGCCCGCGGCCGTGCC
GGTAGGGGACCGTGGCTATC -> GTAGGGGACCGTGGCTATCC
CAAGGGAATCTAGGACGTTA -> AAGGGAATCTAGGACGTTAC
GATAGAAGGATTCTCCTCGA -> ATAGAAGGATTCTCCTCGAT
TCGGGTGTACCGTGTCGGTA -> CGGGTGTACCGTGTCGGTAA
GGGTCGGGTGTACCGTGTCG -> GGTCGGGTGTACCGTGTCGG
GATGACTGACCTAGTGACAC -> ATGACTGACCTAGTGACACC
CCACGGGATTGATATCGGCA -> CACGGGATTGATATCGGCAT
TATCGGCATCCGGTAGGGGA -> ATCGGCATCCGGTAGGGGAC
GTGGCTATCCATTATACAGC -> TGGCTATCCATTATACAGCT
GAGGCTTAACTAAATTTCGT -> AGGCTTAACTAAATTTCGTC
TACTGTGGAGGCTTAACTAA -> ACTGTGGAGGCTTAACTAAA
AAGCTAACTCAAGGCGCCTC -> AGCTAACTCAAGGCGCCTCA
GTTGTTGAAGTATAGTAGGC -> TTGTTGAAGTATAGTAGGCC
ACATGATTGAGCCAAAGGAG -> CATGATTGAGCCAAAGGAGC
TAATTAAGGTTTTACGTAAT -> AATTAAGGTTTTACGTAATC
ATGTGGACAACTCAAATGTG -> TGTGGACAACTCAAATGTGT
AGTATATCCGCCCGCAAGCT -> GTATATCCGCCCGCAAGCTA
GGTTGGACATAATAGTAGGG -> GTTGGACATAATAGTAGGGG
TTGGACATAATAGTAGGGGC -> TGGACATAATAGTAGGGGCG
CGGGTTTTCGTAGAACCTTT -> GGGTTTTCGTAGAACCTTTA
TGAGCAATTCCACGGGATTG -> GAGCAATTCCACGGGATTGA
ACTCAAATGTGTGCACGGGT -> CTCAAATGTGTGCACGGGTC
AGCGGGTTGGACATAATAGT -> GCGGGTTGGACATAATAGTA
CCATGGCGTTTCTCGTTATA -> CATGGCGTTTCTCGTTATAC
TTCTCCTCGATATATACCGT -> TCTCCTCGATATATACCGTT
AAGTTGACCCCACCAATTAG -> AGTTGACCCCACCAATTAGT
ATAAACCAATTACTCTGGCC -> TAAACCAATTACTCTGGCCC
GGGGCGAGCCTTGAAGAAGT -> GGGCGAGCCTTGAAGAAGTT
TAGTAGGCCGTGCTAGCTGA -> AGTAGGCCGTGCTAGCTGAC
CATCCGGTAGGGGACCGTGG -> ATCCGGTAGGGGACCGTGGC
AATTACTCTGGCCCGCGGCC -> ATTACTCTGGCCCGCGGCCG
AGTACCTTATCGCGTTACCG -> GTACCTTATCGCGTTACCGT
GTTACTTTGCGTGTTCAGGG -> TTACTTTGCGTGTTCAGGGA
GAGCTGTAGGTCCCAAGCCT -> AGCTGTAGGTCCCAAGCCTC
GTTTTCGTAGAACCTTTATT -> TTTTCGTAGAACCTTTATTC
ACCGTGGCTATCCATTATAC -> CCGTGGCTATCCATTATACA
TTTGCGTGTTCAGGGATTGA -> TTGCGTGTTCAGGGATTGAG
TGACCTAGTGACACCAAGGT -> GACCTAGTGACACCAAGGTA
ATCGGCATCCGGTAGGGGAC -> TCGGCATCCGGTAGGGGACC
GTGTACCGTGTCGGTAACTA -> TGTACCGTGTCGGTAACTAT
CTTTTTGAGTAATCTAAGAA -> TTTTTGAGTAATCTAAGAAT
TTAATTGCGCGACAGGGTTA -> TAATTGCGCGACAGGGTTAA
AGGGGACCGTGGCTATCCAT -> GGGGACCGTGGCTATCCATT
CTAATTGACTACAGATGACT -> TAATTGACTACAGATGACTG
GATATCGGCATCCGGTAGGG -> ATATCGGCATCCGGTAGGGG
ACACTACTTTTTGAGTAATC -> CACTACTTTTTGAGTAATCT
ACTCAAGGCGCCTCACGTGT -> CTCAAGGCGCCTCACGTGTC
GCGATACTGTGGAGGCTTAA -> CGATACTGTGGAGGCTTAAC
TCCATACGACCGCCTGCGAT -> CCATACGACCGCCTGCGATA
TTATCGCGTTACCGTCTTAG -> TATCGCGTTACCGTCTTAGT
TCGGCATCCGGTAGGGGACC -> CGGCATCCGGTAGGGGACCG
TTCGTAGAACCTTTATTCAT -> TCGTAGAACCTTTATTCATG
CCAAGCCTCTGGGGAGATAG -> CAAGCCTCTGGGGAGATAGA
TGACCCCACCAATTAGTACC -> GACCCCACCAATTAGTACCT
TGGCCGGAAATCACCCCCCT -> GGCCGGAAATCACCCCCCTG
ACTACAGATGACTGACCTAG -> CTACAGATGACTGACCTAGT
TAGTGACACCAAGGTAGCTA -> AGTGACACCAAGGTAGCTAC
TGAAACTTCTAATTGACTAC -> GAAACTTCTAATTGACTACA
ATTCTCCTCGATATATACCG -> TTCTCCTCGATATATACCGT
GTATAGTAGGCCGTGCTAGC -> TATAGTAGGCCGTGCTAGCT
TATATGCTAACGCTGGTATC -> ATATGCTAACGCTGGTATCC
ACCTTATCGCGTTACCGTCT -> CCTTATCGCGTTACCGTCTT
CTACTAGATATCGAGCGGCA -> TACTAGATATCGAGCGGCAT
